**********XX*****XXXXX********X
XXX***XXX******X**********XX***
XXX*X*X***XXXXXXXXXXXXXXXXXXXXX
XXX*X*X*X*XXXXXXXXXXXXXXX***X*X
XXX*X*XXX*XXXXXXXXXXXXXXX*X*X*X
XXX*X*********************X***X
XXXXXXXXXXXXXXXXXXXXXXXXXXXXXXX
