##################
#               O#
# P       ########
#                #
#        X       #
#######  O    ####
#   O##          #
#    ##          #
#            XX  #
#                #
##################
